NO src/texture/eagle.xpm
SO src/texture/red.xpm
EA src/texture/purplestone.xpm

F       55 , 55 , 55

C    0,0,0

WE src/texture/greystone.xpm

111111111111111111111111111111111111111110
100000000000000000000000000000000000000001
100000000000000000000000000000000000000010
10000000000000000000S0000000000000000000111111111
1000000000000000000000000000000000000000111111101
1000000000000000000000000000000000000000000000101
1111111111111111111111111111111111111111111110101
1111111111111111111111111111111111111111111110101
1111111111111111111111111111111111111111111110101
1111111111111111111111111111111111111111111110001
1111111111111111111111111111111111111111111111111