NO src/texture/red.xpm
SO src/texture/red.xpm
WE src/texture/red.xpm
EA src/texture/red.xpm
F 220,100,0
C 225,30,0
 11111111
100111001
10010100011111111111111111111111111111111
1001000010000000000N00000000000000000001
11111111111111111111111111111111111111111111