NO src/texture/red.xpm
SO src/texture/red.xpm
WE src/texture/red.xpm
EA src/texture/red.xpm
F 220,100,0
C 225,30,0
111111111
100111001
10010100111111111111111111111111111111111
10010N001000000000000000000000000000000101
111111111111100011111111111111111111111111111
111111111111111001
11111111110010101
11111111111110001
111111111111111101
11111111111111111111