NO src/texture/Ice.xpm
SO src/texture/Lava.xpm
EA src/texture/Tree.xpm

F       55 , 255 , 255

C    0,0,0

WE src/texture/Ice.xpm

1111111111
10000000111111
10000000110111
1N00000011111
100000001
100000001
100000001
111111111