NO src/texture/eagle.xpm
SO src/texture/red.xpm
EA src/texture/purplestone.xpm

F       55 , 255 , 255

C    0,0,0

WE src/texture/greystone.xpm

111111111
100000001
1000E0001
100000001
100011001
100001001
100111001
111111011
111111011
100000001
100000001
100000001
100011001
100001001
100111001
111111111
111111111
100000001
100000001
100000001
100011001
100001001
100111001
111111111
111111111
100000001
100000001
100000001
100011001
100001001
100111001
111111111
111111111
100000001
100000001
100000001
100011001
100001001
100111001
111111111