NO src/texture/red.xpm
SO src/texture/red.xpm
WE src/texture/red.xpm
EA src/texture/red.xpm
F 220,100,0
C 225,30,0

11111111
11111111 
10000001
10000001
10000001
10000001
10000001
10000001   
1E000001
11111111