NO src/texture/red.xpm
SO src/texture/red.xpm
WE src/texture/red.xpm
EA src/texture/red.xpm
F 220,100,0
C 225,30,0
1111111111
1000000001
1000000001
1000000001
100E000001
1000000001
1000000001
1000000001
1111111111