NO                        src/maps/valid_map.cub    
F      0    ,    25,       120

EA    src/maps/valid_map.cub

C                255      , 5,255

WE               src/maps/valid_map.cub      

SO       src/maps/valid_map.cub   


111111111111111111111111111
100000000000000000000000001
100000000000000000000000001
100000000000000000000000001
100000000000N00000000000001
100000000000000000000000001
100000000000000000000000001
111111111111111111111111111
	11111000000000000000011111
		1000000000000000000000111
	111111111111111111111111111
		111111111111111111111111111
111111111111111111111111111